
F 255,255,255
NO ./textures/NO.xpm    
WE textures/WE.xpm
C 255,255,255
SO ./textures/SO.xpm
EA ./textures/EA.xpm

11111111111
10000100001
10000100001
10000000001
10000N00001
11111111111
1
1
1
1
1
1
1
1