F    255    , 255, 0 
NO ./Assets/pineapple_wall.xpm



WE ./Assets/castle_wall.xpm


C 255,255,255
SO ./Assets/snow_wall.xpm
EA ./Assets/grass_wall.xpm

111111111
112000011
12N1111
1121
111