
F 255,255,255
NO ./textures/NO.xpm    
WE textures/WE.xpm
C 255,255,255
SO ./textures/SO.xpm
EA ./textures/EA.xpm

11111111111
10000100001
10000100001
10000011101
10000000001
10000S00001
10000000001
10000000001
10000000001
11111111111