
   F   fds
NO    ./textures/NO.xpm   
   WE       textures/WE.xpm
SO   ./textures/SO.xpm  

C fffff

   EA ./textures/EA.xpm



 11111  1111 11111
100001  1001 10001
100001111001 11111
100N00000001
100001111111
11111