
   F   fds
NO    ./textures/NO.xpm   
   WE       textures/WE.xpm
SO   ./textures/SO.xpm  

C fffff

EA ./textures/EA.xpm

111111  1111
100001  1001
100001111001
100000E000111
100001111111
111111