
F    255    , 255, 0 
NO ./textures/NO.xpm



WE textures/WE.xpm


C 255,255,255
SO ./textures/SO.xpm
EA ./textures/EA.xpm

1111111111111
1000010000001
1000010000001
1000010000001
1000000100001
11110S0011111
1000000000001
1000010000001
1000010000001
1000010000001
111111111111